t,t,t,t,t,t,t,t,t,t,t,t
t,g,i,g,g,g,g,g,g,b,i,t
t,b,b,b,b,b,b,b,b,b,g,t
t,g,b,b,b,g,g,i,b,b,g,t
t,g,b,i,b,b,b,b,b,b,g,t
t,g,b,g,b,w,w,b,g,b,g,t
t,g,b,g,b,w,w,b,g,b,g,t
t,g,b,b,b,b,b,b,i,b,g,t
t,g,b,b,i,g,g,b,b,b,g,t
t,g,b,b,b,b,b,b,b,b,b,t
t,i,b,g,g,g,g,g,g,g,i,t
t,t,t,t,t,t,t,t,t,t,t,t
