t,t,t,t,t,t,t,t,t,t,t,t
t,g,g,g,g,g,g,g,g,g,g,t
t,g,g,g,g,g,g,g,g,g,g,t
t,g,g,b,b,g,g,b,b,g,g,t
t,g,b,b,b,b,b,b,b,b,g,t
t,g,b,b,b,b,b,b,b,b,g,t
t,g,g,b,b,b,b,b,b,g,g,t
t,g,g,g,b,b,b,b,g,g,g,t
t,g,g,g,g,b,b,g,g,g,g,t
t,g,g,g,g,g,g,g,g,g,g,t
t,g,g,g,g,g,g,g,g,g,g,t
t,t,t,t,t,t,t,t,t,t,t,t
